111111111111111111111111
1000CC000000000000000001
1000P00CCCCC000000000001
100000000000000000000C01
111111111000000000011111
100000000000000000000011
100000000000000000001111
1CC000000000000000111111
100000000000000E000C1111
111111111111111111111111