1111111111111111111111111111111111111111111111111111111111111111
1000000000000000000000000000000000000000000000000000000P00000001
1100000000000000000000000000000000000000000000000000000C00011111
1000000000000000000000000000000000000000000000000000000E00000011
1111111111111111111111111111111111111111111111111111111111111111
