111111111111111111111111
100100000000000000000001
10C000000000010000000001
111100000000010000000001
11000000C000010000011111
100000000000010000000011
101111111100010000001111
1000P0000100010000111111
100000000111110E00001111
111111111111111111111111