111111111111111111111111
100000000000000000000001
10C000010000011111111111
100000000000010E00000001
110000010000010000011111
10000P00000001000C000011
100000000100010000001111
100000000100010000111111
100000000111110C00001111
111111111111111111111111