111111111111111111111111
100000000000000000000001
100000000000000000000001
100000000000000E00000001
110000000000000000011111
100000000000000P00000011
100000000000000000001111
100000000000000000111111
100000000000000000001111
111111111111111111111111