111111111111111111111111
100000000000000000000001
100000000000000000000001
100000000000000P00000001
110000000000000C00011111
100000000000000000000011
100000000000000000001111
100000000000000000000011
100000000000000000001111
100000000000000000000011
100000000000000000000011
100000000000000000000011
100000000000000000001111
100000000000000000000011
100000000000000000001111
100000000000000000000011
100000000000000000000011
100000000000000000001111
100000000000000000001111
100000000000000000000011
100000000000000000001111
100000000000000000000011
100000000000000000000011
100000000000000000000011
100000000000000000000011
100000000000000000001111
100000000000000000000011
100000000000000000000011
100000000000000000000011
100000000000000000000011
100000000000000E00001111
100000000000000000001111
100000000000000000111111
100000000000000000001111
111111111111111111111111