111111111111111111111111111111111111111111111111111111111111111111111111111111111111111111111111
100000000000000000000000000000000000000000000000000000000000000000000000000000000000000P00000001
110000000000000000000000000000000000000000000000000000000000000000000000000000000000000C00011111
100000000000000000000000000000000000000000000000000000000000000000000000000000000000000E00000011
111111111111111111111111111111111111111111111111111111111111111111111111111111111111111111111111
